00 00 00 00 00 00 00 00 00 00 00 00 00 00 00 00 00 00 00 00 00 00 00 00 00 00 00 00 00 00 00 00 00 00 00 00 00 00 00 00 00 00 00 00 00 00 00 00 00 00 00 00 00 00 00 00 00 00 00 00 00 00 00 00 00 00 00 00 00 00 00 00 00 00 00 00 00 00 00 00 00 00 00 00 00 00 00 00 00 00 00 00 00 00 00 00 00 00 00 00 00 00 00 00 00 00 00 00 00 00
00 00 00 00 00 00 00 00 00 00 00 00 00 00 00 00 00 00 00 00 00 00 00 00 00 00 00 00 00 00 00 00 00 00 00 00 00 00 00 00 00 00 00 00 00 00 00 00 00 00 00 00 00 00 00 00 00 00 00 00 00 00 00 00 00 00 00 00 00 00 00 00 00 00 00 00 00 00 00 00 00 00 00 00 00 00 00 00 00 00 00 00 00 00 00 00 00 00 00 00 00 00 00 00 00 00 00 00 00 00
00 00 00 00 00 00 00 00 00 00 00 00 00 00 00 00 00 00 00 00 00 00 00 00 00 00 00 00 00 00 00 00 00 00 00 00 00 00 00 00 00 00 00 00 00 00 00 00 00 00 00 00 00 00 00 00 00 00 00 00 00 00 00 00 00 00 00 00 00 00 00 00 00 00 00 00 00 00 00 00 00 00 00 00 00 00 00 00 00 00 00 00 00 00 00 00 00 00 00 00 00 00 00 00 00 00 00 00 00 00
00 00 00 00 00 00 00 00 00 00 00 00 00 00 00 00 00 00 00 00 00 00 00 00 00 00 00 00 00 00 00 00 00 00 00 00 00 00 00 00 00 00 00 00 00 00 00 00 00 00 00 00 00 00 00 00 00 00 00 00 00 00 00 00 00 00 00 00 00 00 00 00 00 00 00 00 00 00 00 00 00 00 00 00 00 00 00 00 00 00 00 00 00 00 00 00 00 00 00 00 00 00 00 00 00 00 00 00 00 00
00 00 00 00 00 00 00 00 00 00 00 00 00 00 00 00 00 00 00 00 00 00 00 00 15 15 15 15 15 15 15 15 15 15 15 15 15 15 15 15 15 15 15 15 15 15 15 15 15 15 15 15 15 15 15 15 15 15 00 00 00 00 00 00 00 00 00 00 00 00 00 00 00 00 00 00 00 00 00 00 00 00 00 00 00 00 00 00 00 00 00 00 00 00 00 00 00 00 00 00 00 00 00 00 00 00 00 00 00 00
00 00 00 00 00 54 56 67 67 67 67 67 67 67 67 67 67 70 75 93 93 93 93 93 15 15 15 15 15 15 15 15 16 02 02 02 22 23 23 23 23 23 23 23 23 17 15 15 15 15 15 15 15 15 15 15 15 15 74 75 69 67 67 67 67 67 67 67 67 67 67 57 55 13 13 13 93 93 93 93 93 93 93 93 13 13 13 13 13 13 13 13 09 07 10 10 10 10 10 10 10 96 96 96 96 00 00 00 00 00
00 00 00 00 00 67 67 67 67 67 67 67 67 67 67 70 75 93 93 93 93 93 93 15 15 15 15 15 15 15 15 15 16 02 02 02 02 02 02 02 02 02 02 02 02 14 15 15 15 15 15 15 15 15 15 15 15 15 15 15 74 69 67 67 67 67 67 67 67 67 67 67 57 54 55 13 13 13 93 93 93 13 13 13 13 13 13 13 13 13 13 13 13 09 06 07 10 10 10 10 10 10 96 96 96 00 00 00 00 00
00 00 00 00 00 67 67 67 67 67 67 67 67 67 70 76 93 93 93 93 93 93 15 15 15 15 15 15 15 15 15 18 24 02 02 02 02 02 02 02 02 02 02 02 02 22 15 15 15 15 15 15 15 93 93 93 93 93 93 93 93 74 75 69 67 67 67 67 67 67 67 67 67 67 57 54 55 13 13 13 13 13 13 13 13 13 13 13 13 13 13 13 13 13 13 09 07 10 10 10 10 10 96 96 96 00 00 00 00 00
00 00 00 00 00 67 67 67 67 67 67 67 67 70 76 93 93 93 93 93 93 15 15 15 15 15 15 18 23 23 23 24 02 02 02 02 02 02 02 02 02 02 02 02 02 02 22 23 17 15 15 15 15 15 93 93 93 93 93 93 93 93 93 74 75 69 67 67 67 67 67 67 67 67 67 67 57 55 13 13 13 13 13 13 13 13 13 13 13 13 13 13 13 13 13 13 09 07 10 10 10 10 96 96 96 00 00 00 00 00
00 00 00 00 00 67 67 67 67 67 67 67 70 76 93 93 93 93 93 15 15 15 15 15 18 23 23 24 02 02 02 02 02 02 02 02 02 02 02 02 02 02 02 02 02 02 02 02 22 17 15 15 15 15 15 93 93 93 93 93 93 93 93 93 93 74 69 67 67 67 67 67 67 67 67 67 67 57 54 55 13 13 13 13 13 13 13 13 13 13 13 13 13 13 13 13 13 09 07 10 10 10 96 96 96 00 00 00 00 00
00 00 00 00 00 67 67 67 67 67 67 70 76 93 93 93 93 15 15 15 15 15 18 23 24 02 02 02 02 02 02 02 02 02 02 02 02 02 02 02 02 02 02 02 02 02 02 02 02 14 18 17 15 15 15 93 93 93 93 93 93 93 93 93 93 93 93 69 67 67 67 67 67 67 67 67 67 67 67 57 54 54 55 13 13 13 13 13 13 13 13 13 93 13 13 13 13 13 16 10 10 10 10 96 10 00 00 00 00 00
00 00 00 00 00 67 67 67 70 75 75 76 93 93 93 93 15 15 15 15 15 18 24 02 02 02 02 02 02 02 02 02 02 02 02 02 02 02 02 02 02 02 02 02 02 02 02 02 02 14 16 22 23 17 15 15 15 15 93 93 93 93 93 93 93 93 93 93 75 69 67 67 67 67 67 67 67 67 67 67 67 67 57 54 54 55 13 13 13 13 13 13 93 93 13 13 13 13 09 07 10 10 10 96 96 00 00 00 00 00
00 00 00 00 00 67 67 67 68 93 93 93 93 93 93 93 15 15 15 18 23 24 02 02 29 30 30 30 30 30 30 30 30 30 30 30 30 30 30 30 30 30 30 31 02 02 02 02 02 14 16 02 02 22 17 15 15 15 15 93 15 93 93 93 93 93 93 93 93 74 69 67 67 67 67 67 67 67 67 67 67 67 67 67 67 57 54 55 13 13 13 13 13 93 93 13 13 13 13 09 07 10 10 10 96 00 00 00 00 00
00 00 00 00 00 67 67 67 68 93 93 93 93 93 93 15 15 15 18 24 02 02 02 02 35 02 02 02 02 02 02 02 02 02 02 02 02 01 01 02 02 01 01 37 02 02 02 01 02 14 16 02 02 02 22 17 15 15 15 15 15 93 93 93 93 93 93 93 93 93 74 69 67 67 67 67 67 67 67 67 67 67 67 67 67 67 67 57 54 54 54 55 13 13 93 93 93 93 93 93 09 07 10 10 96 00 00 00 00 00
00 00 00 00 00 67 67 70 76 93 93 93 93 15 15 15 15 18 24 02 02 02 02 02 35 02 02 02 02 02 02 02 48 49 50 02 02 01 02 01 02 02 01 37 02 02 02 02 02 14 16 02 02 02 02 22 23 23 23 23 17 15 93 93 93 93 93 93 93 93 93 93 69 67 67 67 67 67 67 67 67 67 67 67 67 67 67 67 67 67 67 57 54 55 13 13 93 93 93 93 93 93 07 10 10 00 00 00 00 00
00 00 00 00 00 67 67 68 93 93 93 93 93 15 18 23 23 24 02 02 02 02 02 02 35 02 02 02 02 02 02 48 51 62 52 50 02 02 02 01 02 02 02 37 02 01 02 02 02 14 16 02 02 02 02 02 02 02 02 02 14 15 15 93 93 93 93 93 93 93 93 93 93 69 67 67 67 67 67 67 67 67 67 67 67 67 67 67 67 67 67 67 67 57 54 55 13 13 93 93 93 93 93 93 07 00 00 00 00 00
00 00 00 00 00 75 75 93 93 93 93 93 93 21 24 02 02 29 30 30 30 30 30 30 32 02 02 02 48 49 49 51 97 97 62 52 49 50 02 02 02 01 02 37 02 01 02 01 02 14 16 02 02 02 02 02 02 02 02 02 22 17 15 93 15 93 93 93 93 93 93 93 93 93 69 67 67 67 67 67 67 67 67 67 67 67 67 67 67 67 67 67 67 67 67 57 55 13 93 93 93 93 93 93 93 00 00 00 00 00
00 00 00 00 00 93 93 93 93 93 93 93 24 11 02 02 01 35 02 02 02 02 02 02 02 02 02 02 61 62 62 62 97 62 62 62 62 52 50 02 01 02 02 37 02 01 02 02 02 14 16 02 02 02 02 02 02 02 02 02 02 22 17 15 15 15 93 93 93 93 93 93 93 93 93 69 67 67 67 67 67 67 67 67 67 67 67 67 67 67 67 67 67 67 67 67 57 54 55 93 93 93 93 93 93 00 00 00 00 00
00 00 00 00 00 93 93 93 93 93 24 95 95 11 02 01 01 35 02 02 02 02 02 02 02 02 02 02 61 62 62 97 97 98 98 98 62 62 63 02 01 01 02 37 02 02 01 02 02 14 16 02 02 02 02 02 02 02 02 02 02 02 22 23 17 15 15 93 93 93 93 93 93 93 93 74 69 67 67 67 67 67 67 67 67 67 67 67 67 67 67 67 67 67 67 67 67 67 57 55 13 93 93 93 93 00 00 00 00 00
00 00 00 00 00 93 93 93 23 24 95 95 95 11 02 02 02 35 02 48 49 49 49 49 49 49 49 49 51 97 97 97 98 98 98 62 62 62 63 01 02 01 02 37 02 01 02 02 02 14 16 02 02 02 02 02 02 02 02 02 02 02 02 02 22 23 17 15 93 93 93 93 93 93 93 93 74 69 67 67 67 67 67 67 67 67 67 67 67 67 67 67 67 67 67 67 67 67 67 57 55 13 93 93 93 00 00 00 00 00
00 00 00 00 00 93 93 24 95 95 95 95 95 11 02 01 02 35 02 61 65 72 72 72 72 72 72 72 64 62 97 62 62 98 98 62 65 72 73 01 01 01 02 37 02 01 02 01 02 14 16 02 02 02 02 02 02 02 02 02 02 02 02 02 02 02 22 23 17 15 93 93 93 93 93 93 93 93 75 69 67 67 67 67 67 67 67 67 67 67 67 67 67 67 67 67 67 67 67 67 57 54 55 93 93 00 00 00 00 00
00 00 00 00 00 93 24 95 95 95 95 95 95 11 02 01 01 35 02 61 63 02 02 02 02 02 02 02 71 72 64 62 62 62 65 72 73 02 02 02 02 02 02 37 02 01 02 02 02 14 16 02 02 02 02 02 01 02 02 02 02 02 02 02 02 02 02 02 22 23 17 15 15 93 93 93 93 93 93 74 69 67 67 67 67 67 67 67 67 67 67 67 67 67 67 67 67 67 67 67 67 67 57 55 93 00 00 00 00 00
00 00 00 00 00 93 95 95 95 95 95 95 95 11 02 02 02 35 02 61 63 02 01 01 01 02 02 02 02 02 71 64 62 62 63 02 02 02 02 02 02 02 02 37 02 01 01 01 02 14 16 02 29 30 31 02 02 02 02 02 02 02 02 02 02 02 02 02 02 02 22 17 15 15 15 93 93 93 93 93 74 69 67 67 67 67 67 67 67 67 67 67 67 67 67 67 67 67 67 67 67 67 67 57 54 00 00 00 00 00
00 00 00 00 00 24 01 26 27 27 27 27 27 19 27 28 02 35 02 61 63 02 01 01 01 01 01 01 01 02 02 71 72 72 73 02 02 02 02 02 02 02 02 37 02 02 02 01 02 14 16 02 35 36 37 01 02 02 02 02 02 02 02 02 02 02 02 02 02 02 02 22 17 15 15 15 15 15 93 93 15 74 69 67 67 67 67 67 67 67 67 67 67 67 67 67 67 67 67 67 67 67 67 67 67 00 00 00 00 00
00 00 00 00 00 95 95 95 95 95 95 95 95 11 02 02 02 35 02 61 63 02 02 01 01 02 01 02 01 01 02 02 02 02 02 02 02 02 02 02 02 02 02 37 02 01 01 01 02 14 16 02 43 44 45 02 02 02 02 02 02 02 02 02 02 02 02 02 02 02 02 02 22 17 15 15 15 15 15 15 15 15 74 69 67 67 67 67 67 67 67 67 67 67 67 67 67 67 67 67 67 67 67 67 67 00 00 00 00 00
00 00 00 00 00 95 95 95 95 95 95 95 95 11 01 01 01 35 02 61 63 02 01 01 02 02 01 01 01 01 01 01 01 01 01 02 02 02 02 02 02 02 02 37 02 02 02 02 02 14 16 02 02 02 02 02 02 01 01 01 02 02 02 02 02 02 02 02 02 02 02 02 02 22 17 15 15 15 15 15 15 15 15 66 67 67 67 67 67 67 67 67 67 67 67 67 67 67 67 67 67 67 67 67 67 00 00 00 00 00
00 00 00 00 00 95 95 95 95 95 95 95 95 11 02 01 01 35 02 61 63 02 01 01 02 03 02 01 01 01 01 01 01 01 01 02 02 39 44 44 44 44 44 45 02 02 02 02 02 14 16 02 02 02 02 02 02 02 02 01 01 02 02 02 02 02 02 02 02 02 02 02 02 02 22 17 15 15 15 15 15 15 15 74 69 67 67 67 67 67 67 67 67 67 67 67 67 67 67 67 67 67 67 67 67 00 00 00 00 00
00 00 00 00 00 95 95 95 95 95 95 95 95 11 02 01 01 35 02 61 63 02 01 02 02 11 02 02 01 01 01 01 01 01 01 02 02 37 02 02 02 02 02 02 02 02 02 02 02 14 16 02 02 02 02 01 01 02 02 02 02 01 02 02 02 02 02 02 02 02 02 02 02 02 02 22 23 23 17 15 15 15 15 15 66 67 67 67 67 67 67 67 67 67 67 67 67 67 67 67 67 67 67 67 67 00 00 00 00 00
00 00 00 00 00 95 95 95 95 95 95 95 95 11 02 01 02 02 02 61 63 02 01 02 02 11 02 02 02 02 02 02 02 02 02 02 02 37 02 02 02 02 02 02 02 02 02 02 02 14 16 02 02 02 02 02 02 02 02 02 01 02 02 02 02 02 02 02 02 02 02 02 02 02 02 02 02 02 14 15 15 15 15 15 66 67 67 67 67 67 67 67 67 67 67 67 67 67 67 67 67 67 67 67 67 00 00 00 00 00
00 00 00 00 00 95 95 95 95 95 95 95 95 02 02 01 01 01 02 61 63 02 02 02 05 04 07 02 02 02 02 44 44 44 44 44 44 45 02 02 02 02 02 02 02 02 02 02 02 14 16 02 02 02 01 02 02 02 01 01 01 02 02 02 02 02 02 02 02 02 02 02 02 02 02 02 02 02 14 15 15 15 15 15 66 67 67 67 67 67 67 67 67 67 67 67 67 67 67 67 67 67 67 67 67 00 00 00 00 00
00 00 00 00 00 95 95 95 95 95 95 95 95 95 02 27 27 27 27 89 90 27 27 27 12 15 09 06 06 06 06 06 06 06 06 06 06 06 06 06 06 06 06 06 06 06 06 06 06 04 16 02 02 02 01 02 02 02 02 02 02 02 02 02 02 02 02 02 02 02 02 02 02 02 02 02 02 02 14 15 15 15 15 15 66 67 67 67 67 67 67 67 67 67 67 67 67 67 67 67 67 67 67 67 67 00 00 00 00 00
00 00 00 00 00 49 49 49 49 49 49 50 02 02 02 02 02 02 02 61 63 10 10 10 22 23 23 23 23 23 23 23 23 23 23 17 18 23 23 23 23 23 23 23 23 23 23 23 23 23 16 02 02 02 02 02 02 02 01 02 02 02 02 02 02 02 02 02 02 02 02 02 02 02 02 02 02 05 08 15 15 15 15 15 66 67 67 67 67 67 67 67 67 67 67 67 67 67 67 67 67 67 67 67 67 00 00 00 00 00
00 00 00 00 00 62 62 62 62 62 62 52 49 49 49 49 49 49 49 51 63 10 10 29 44 44 44 44 44 44 44 44 44 44 44 14 16 30 30 30 31 02 02 02 02 02 02 02 02 02 11 02 02 02 01 02 02 02 01 02 01 02 02 02 02 02 02 02 02 02 02 02 02 02 05 06 06 08 15 15 15 15 15 15 66 67 67 67 67 67 67 67 67 67 67 67 67 67 67 67 67 67 67 67 67 00 00 00 00 00
00 00 00 00 00 62 62 62 62 62 62 65 72 72 72 72 72 72 72 72 73 10 10 35 02 02 01 01 01 01 02 02 02 02 02 14 16 02 02 02 37 02 02 02 02 02 02 02 02 02 11 02 02 02 01 02 02 02 01 01 02 02 02 02 02 02 02 02 02 02 02 02 05 06 08 15 15 15 15 15 15 15 15 15 66 67 67 67 67 67 67 67 67 67 67 67 67 67 67 67 67 67 67 67 67 00 00 00 00 00
00 00 00 00 00 62 98 98 62 65 72 73 10 10 10 10 10 10 10 10 10 10 10 35 02 02 01 02 02 01 02 02 02 02 02 14 16 02 02 02 37 02 02 02 02 02 02 02 02 02 11 02 02 02 02 02 02 01 01 01 02 02 02 02 02 02 02 02 02 02 02 05 08 15 15 15 15 15 15 15 15 15 15 53 67 67 67 67 67 67 67 67 67 67 67 67 67 67 67 67 67 67 67 67 67 00 00 00 00 00
00 00 00 00 00 98 98 62 65 73 10 10 10 10 10 10 10 10 10 10 10 10 10 35 02 01 02 01 02 01 02 02 02 02 02 14 16 02 02 02 37 02 02 02 02 02 02 02 02 02 11 02 02 02 02 01 02 01 01 02 02 02 02 02 02 02 02 05 06 06 06 08 15 15 15 15 15 15 15 15 15 15 53 56 67 67 67 67 67 67 67 67 67 67 67 67 67 67 67 67 67 67 67 67 67 00 00 00 00 00
00 00 00 00 00 72 72 72 73 10 10 10 10 10 10 10 10 10 10 10 10 10 10 35 02 01 01 01 02 02 02 02 02 02 02 14 16 02 02 02 37 02 02 02 02 02 01 01 02 02 11 02 02 01 02 01 01 01 02 02 02 02 02 02 05 06 06 08 15 15 15 15 15 15 93 93 93 15 15 15 53 54 56 67 67 67 67 67 67 67 67 67 67 67 67 67 67 67 67 67 67 67 67 67 67 00 00 00 00 00
00 00 00 00 00 95 95 95 95 95 39 44 44 44 44 44 44 44 44 44 44 44 44 46 02 01 01 02 02 26 27 27 27 27 27 23 24 02 02 02 37 02 02 02 02 02 01 02 02 02 11 02 02 01 01 01 02 02 02 02 02 02 05 06 08 15 15 15 93 93 93 93 93 93 93 93 15 53 54 54 56 67 67 67 67 67 67 67 67 67 67 67 67 67 67 67 67 67 67 67 67 67 67 67 67 00 00 00 00 00
00 00 00 00 00 95 95 95 95 95 37 95 95 02 02 02 02 02 02 02 02 02 02 35 02 01 01 02 02 02 02 02 02 02 02 02 02 02 02 02 37 02 02 02 02 02 02 01 02 02 11 02 02 02 02 02 02 02 02 02 05 06 08 15 15 93 93 93 93 93 93 93 15 53 54 54 54 56 67 67 67 67 67 67 67 67 67 67 67 67 67 67 67 67 67 67 67 67 67 67 67 67 67 67 67 00 00 00 00 00
00 00 00 00 00 95 95 95 95 95 37 95 95 02 02 02 02 100 02 02 02 02 02 35 02 02 01 01 02 02 02 02 02 02 02 02 02 02 02 02 37 02 02 01 02 02 02 01 02 02 11 02 02 02 02 02 02 02 02 05 08 15 15 93 93 93 93 53 54 54 54 54 54 56 67 67 67 67 67 67 67 67 67 67 67 67 67 67 67 67 67 67 67 67 67 67 67 67 67 67 67 67 67 67 67 00 00 00 00 00
00 00 00 00 00 44 44 44 44 44 45 95 95 02 02 02 02 02 02 02 02 02 02 35 02 02 02 02 02 33 34 02 02 02 02 02 02 02 02 02 37 02 02 02 02 02 01 02 02 02 11 02 02 02 02 02 02 02 06 08 15 93 93 93 93 53 54 56 67 67 67 67 67 67 67 67 67 67 67 67 67 67 67 67 67 67 67 67 67 67 67 67 67 67 67 67 67 67 67 67 67 67 67 67 67 00 00 00 00 00
00 00 00 00 00 95 95 95 95 95 95 95 95 02 02 02 02 02 02 02 02 02 02 43 44 44 38 02 02 41 41 02 02 39 44 44 44 44 44 44 45 02 02 02 01 01 01 02 02 02 11 05 06 06 06 06 06 06 08 15 93 93 93 93 53 56 67 67 67 67 67 67 67 67 67 67 67 67 67 67 67 67 67 67 67 67 67 67 67 67 67 67 67 67 67 67 67 67 67 67 67 67 67 67 67 00 00 00 00 00
00 00 00 00 00 30 30 30 30 30 30 30 30 30 30 30 30 30 31 02 02 02 02 02 02 02 35 02 02 02 02 02 02 37 02 02 02 02 02 02 02 02 01 01 01 02 02 02 02 02 14 08 15 15 15 15 15 15 93 93 93 93 93 53 56 67 67 67 67 67 67 67 67 67 67 67 67 67 67 67 67 67 67 67 67 67 67 67 67 67 67 67 67 67 67 67 67 67 67 67 67 67 67 67 67 00 00 00 00 00
00 00 00 00 00 95 95 95 95 95 95 95 02 02 02 02 02 02 37 02 02 02 02 02 02 02 35 02 02 02 02 02 02 37 02 02 01 01 01 02 02 02 01 02 02 02 02 02 02 05 08 15 15 15 15 93 93 93 93 93 93 93 53 56 67 67 67 67 67 67 67 67 67 67 67 67 67 67 67 67 67 67 67 67 67 67 67 67 67 67 67 67 67 67 67 67 67 67 67 67 67 67 67 67 67 00 00 00 00 00
00 00 00 00 00 95 95 95 95 95 95 02 02 02 01 01 02 02 37 02 02 02 02 02 02 02 43 44 44 44 44 44 44 45 02 01 01 02 02 01 01 01 02 01 02 02 02 02 05 08 15 15 93 93 93 93 93 93 53 54 54 54 56 67 67 67 67 67 67 67 67 67 67 67 67 67 67 67 67 67 67 67 67 67 67 67 67 67 67 67 67 67 67 67 67 67 67 67 67 67 67 67 67 67 67 00 00 00 00 00
00 00 00 00 00 95 95 95 95 95 02 02 02 01 01 02 02 02 37 02 02 02 02 02 02 02 02 02 02 02 02 02 02 02 02 01 01 02 01 01 02 01 01 02 02 02 02 05 08 15 93 93 93 93 93 93 93 53 56 67 67 67 67 67 67 67 67 67 67 67 67 67 67 67 67 67 67 67 67 67 67 67 67 67 67 67 67 67 67 67 67 67 67 67 67 67 67 67 67 67 67 67 67 67 67 00 00 00 00 00
00 00 00 00 00 95 95 95 95 95 95 02 02 02 100 01 02 02 37 02 02 02 02 02 02 02 02 02 02 02 01 02 02 02 02 01 01 02 02 02 01 01 01 01 02 02 05 08 15 93 93 93 93 53 54 54 54 56 67 67 67 67 67 67 67 67 67 67 67 67 67 67 67 67 67 67 67 67 67 67 67 67 67 67 67 67 67 67 67 67 67 67 67 67 67 67 67 67 67 67 67 67 67 67 67 00 00 00 00 00
00 00 00 00 00 95 95 95 95 95 01 02 02 02 02 02 02 02 37 02 02 02 02 02 02 02 02 02 01 01 01 02 02 02 02 02 02 02 01 02 02 02 01 02 02 05 08 15 15 93 93 93 54 56 67 67 67 67 67 67 67 67 67 67 67 67 67 67 67 67 67 67 67 67 67 67 67 67 67 67 67 67 67 67 67 67 67 67 67 67 67 67 67 67 67 67 67 67 67 67 67 67 67 67 67 00 00 00 00 00
00 00 00 00 00 95 95 95 95 01 02 02 02 02 02 02 02 02 37 02 02 02 02 02 02 02 02 01 01 02 02 01 02 02 01 02 02 02 02 02 02 02 02 02 05 08 15 15 15 93 93 66 67 67 67 67 67 67 67 67 67 67 67 67 67 67 67 67 67 67 67 67 67 67 67 67 67 67 67 67 67 67 67 67 67 67 67 67 67 67 67 67 67 67 67 67 67 67 67 67 67 67 67 67 67 00 00 00 00 00
00 00 00 00 00 95 95 95 95 02 02 02 02 02 02 02 02 02 37 02 02 02 02 02 02 02 01 01 02 02 02 02 02 02 02 02 02 02 02 02 02 02 02 05 08 15 15 93 93 93 53 56 67 67 67 67 67 67 67 67 67 67 67 67 67 67 67 67 67 67 67 67 67 67 67 67 67 67 67 67 67 67 67 67 67 67 67 67 67 67 67 67 67 67 67 67 67 67 67 67 67 67 67 67 67 00 00 00 00 00
00 00 00 00 00 95 95 95 95 02 02 01 02 02 05 06 06 06 06 06 06 06 06 06 06 06 06 06 06 06 06 06 06 06 06 06 06 06 06 06 06 06 06 08 15 93 93 93 93 53 56 67 67 67 67 67 67 67 67 67 67 67 67 67 67 67 67 67 67 67 67 67 67 67 67 67 67 67 67 67 67 67 67 67 67 67 67 67 67 67 67 67 67 67 67 67 67 67 67 67 67 67 67 67 67 00 00 00 00 00
00 00 00 00 00 95 95 95 02 01 02 02 02 02 22 23 23 23 23 23 23 23 23 23 23 23 23 23 23 23 23 23 23 23 23 23 23 23 23 23 23 23 17 15 93 93 93 93 53 56 67 67 67 67 67 67 67 67 67 67 67 67 67 67 67 67 67 67 67 67 67 67 67 67 67 67 67 67 67 67 67 67 67 67 67 67 67 67 67 67 67 67 67 67 67 67 67 67 67 67 67 67 67 67 67 00 00 00 00 00
00 00 00 00 00 95 95 95 95 95 95 95 95 95 95 95 95 95 95 95 37 95 95 95 95 95 95 95 95 95 95 95 95 95 95 95 95 95 95 95 95 05 08 93 93 93 93 53 56 67 67 67 67 67 67 67 67 67 67 67 67 67 67 67 67 67 67 67 67 67 67 67 67 67 67 67 67 67 67 67 67 67 67 67 67 67 67 67 67 67 67 67 67 67 67 67 67 67 67 67 67 67 67 67 67 00 00 00 00 00
00 00 00 00 00 95 95 95 95 95 95 95 95 95 95 95 95 95 95 95 37 95 95 95 95 95 95 95 95 95 95 95 95 95 95 95 95 95 95 95 95 14 93 93 93 93 53 56 67 67 67 67 67 67 67 67 67 67 67 67 67 67 67 67 67 67 67 67 67 67 67 67 67 67 67 67 67 67 67 67 67 67 67 67 67 67 67 67 67 67 67 67 67 67 67 67 67 67 67 67 67 67 67 67 67 00 00 00 00 00
00 00 00 00 00 95 95 95 95 95 95 95 95 95 95 95 95 95 95 95 37 95 95 95 95 95 95 95 95 95 95 95 95 95 95 95 95 95 95 95 95 14 93 93 93 93 56 67 67 67 67 67 67 67 67 67 67 67 67 67 67 67 67 67 67 67 67 67 67 67 67 67 67 67 67 67 67 67 67 67 67 67 67 67 67 67 67 67 67 67 67 67 67 67 67 67 67 67 67 67 67 67 67 67 67 00 00 00 00 00
00 00 00 00 00 00 00 00 00 00 00 00 00 00 00 00 00 00 00 00 00 00 00 00 00 00 00 00 00 00 00 00 00 00 00 00 00 00 00 00 00 00 00 00 00 00 00 00 00 00 00 00 00 00 00 00 00 00 00 00 00 00 00 00 00 00 00 00 00 00 00 00 00 00 00 00 00 00 00 00 00 00 00 00 00 00 00 00 00 00 00 00 00 00 00 00 00 00 00 00 00 00 00 00 00 00 00 00 00 00
00 00 00 00 00 00 00 00 00 00 00 00 00 00 00 00 00 00 00 00 00 00 00 00 00 00 00 00 00 00 00 00 00 00 00 00 00 00 00 00 00 00 00 00 00 00 00 00 00 00 00 00 00 00 00 00 00 00 00 00 00 00 00 00 00 00 00 00 00 00 00 00 00 00 00 00 00 00 00 00 00 00 00 00 00 00 00 00 00 00 00 00 00 00 00 00 00 00 00 00 00 00 00 00 00 00 00 00 00 00
00 00 00 00 00 00 00 00 00 00 00 00 00 00 00 00 00 00 00 00 00 00 00 00 00 00 00 00 00 00 00 00 00 00 00 00 00 00 00 00 00 00 00 00 00 00 00 00 00 00 00 00 00 00 00 00 00 00 00 00 00 00 00 00 00 00 00 00 00 00 00 00 00 00 00 00 00 00 00 00 00 00 00 00 00 00 00 00 00 00 00 00 00 00 00 00 00 00 00 00 00 00 00 00 00 00 00 00 00 00
00 00 00 00 00 00 00 00 00 00 00 00 00 00 00 00 00 00 00 00 00 00 00 00 00 00 00 00 00 00 00 00 00 00 00 00 00 00 00 00 00 00 00 00 00 00 00 00 00 00 00 00 00 00 00 00 00 00 00 00 00 00 00 00 00 00 00 00 00 00 00 00 00 00 00 00 00 00 00 00 00 00 00 00 00 00 00 00 00 00 00 00 00 00 00 00 00 00 00 00 00 00 00 00 00 00 00 00 00 00
00 00 00 00 00 00 00 00 00 00 00 00 00 00 00 00 00 00 00 00 00 00 00 00 00 00 00 00 00 00 00 00 00 00 00 00 00 00 00 00 00 00 00 00 00 00 00 00 00 00 00 00 00 00 00 00 00 00 00 00 00 00 00 00 00 00 00 00 00 00 00 00 00 00 00 00 00 00 00 00 00 00 00 00 00 00 00 00 00 00 00 00 00 00 00 00 00 00 00 00 00 00 00 00 00 00 00 00 00 00
