00 00 00 00 00 00 00 00 00 00 00 00 00 00 00 00 00 00 00 00 00 00 00 00 00 00 00 00 00 00 00 00 00 00 00 00 00 00 00 00 00 00 00 00 00 00 00 00 00 00 00 00 00 00 00 00 00 00 00 00 00 00 00 00 00 00 00 00 00 00 00 00 00 00 00 00 00 00 00 00 00 00 00 00 00 00 00 00 00 00 00 00 00 00 00 00 00 00 00 00 00 00 00 00 00 00 00 00 00 00
00 00 00 00 00 00 00 00 00 00 00 00 00 00 00 00 00 00 00 00 00 00 00 00 00 00 00 00 00 00 00 00 00 00 00 00 00 00 00 00 00 00 00 00 00 00 00 00 00 00 00 00 00 00 00 00 00 00 00 00 00 00 00 00 00 00 00 00 00 00 00 00 00 00 00 00 00 00 00 00 00 00 00 00 00 00 00 00 00 00 00 00 00 00 00 00 00 00 00 00 00 00 00 00 00 00 00 00 00 00
00 00 00 00 00 00 00 00 00 00 00 00 00 00 00 00 00 00 00 00 00 00 00 00 00 00 00 00 00 00 00 00 00 00 00 00 00 00 00 00 00 00 00 00 00 00 00 00 00 00 00 00 00 00 00 00 00 00 00 00 00 00 00 00 00 00 00 00 00 00 00 00 00 00 00 00 00 00 00 00 00 00 00 00 00 00 00 00 00 00 00 00 00 00 00 00 00 00 00 00 00 00 00 00 00 00 00 00 00 00
00 00 00 00 00 00 00 00 00 00 00 00 00 00 00 00 00 00 00 00 00 00 00 00 00 00 00 00 00 00 00 00 00 00 00 00 00 00 00 00 00 00 00 00 00 00 00 00 00 00 00 00 00 00 00 00 00 00 00 00 00 00 00 00 00 00 00 00 00 00 00 00 00 00 00 00 00 00 00 00 00 00 00 00 00 00 00 00 00 00 00 00 00 00 00 00 00 00 00 00 00 00 00 00 00 00 00 00 00 00
00 00 00 00 00 00 00 00 00 00 00 00 00 00 00 00 00 00 00 00 00 00 00 00 00 00 00 00 00 00 00 00 00 00 00 00 00 00 00 00 00 00 00 00 00 00 00 00 00 00 00 00 00 00 00 00 00 00 00 00 00 00 00 00 00 00 00 00 00 00 00 00 00 00 00 00 00 00 00 00 00 00 00 00 00 00 00 00 00 00 00 00 00 00 00 00 00 00 00 00 00 00 00 00 00 00 00 00 00 00
00 00 00 00 00 02 02 02 02 02 02 02 02 02 61 62 62 62 63 02 02 02 01 01 02 02 37 95 95 95 95 95 95 95 95 95 95 95 95 95 95 95 95 95 95 95 95 95 95 95 95 95 95 95 35 95 95 95 95 95 95 95 95 95 95 95 35 96 96 96 96 96 96 96 96 96 96 96 96 61 62 62 62 63 96 96 96 96 96 96 96 96 96 96 96 96 96 96 96 96 96 96 96 96 96 00 00 00 00 00
00 00 00 00 00 02 02 02 02 02 02 48 49 49 51 62 62 62 52 50 02 02 01 02 01 02 37 95 95 95 95 95 95 95 95 95 95 02 02 02 95 95 95 95 95 95 95 95 95 95 95 95 95 95 35 95 95 95 95 95 95 95 95 95 95 95 35 96 96 96 96 96 96 96 96 96 96 96 96 61 62 62 62 63 96 96 96 96 96 96 96 96 96 96 96 96 96 96 96 96 96 96 96 96 96 00 00 00 00 00
00 00 00 00 00 02 02 02 02 02 48 51 62 62 62 62 97 62 62 52 50 02 02 02 01 02 37 95 95 95 95 95 95 02 02 02 02 02 02 02 02 02 02 95 95 95 95 95 95 95 95 95 95 95 35 95 95 95 95 29 30 30 30 30 30 30 32 96 96 96 96 96 96 96 96 96 96 96 96 61 62 62 62 63 96 96 96 96 96 96 96 02 02 96 96 96 96 96 96 96 96 96 96 96 96 00 00 00 00 00
00 00 00 00 00 02 02 48 49 49 51 62 62 62 97 97 97 62 62 62 52 49 50 02 02 02 37 95 95 02 95 95 02 02 02 02 02 02 02 02 02 02 02 02 02 95 95 02 02 95 95 95 95 95 35 95 95 95 95 35 02 02 02 02 02 02 02 02 96 96 96 96 96 96 96 96 96 96 02 61 62 62 62 63 96 02 02 01 02 02 02 02 02 02 02 02 02 02 96 96 96 96 96 96 96 00 00 00 00 00
00 00 00 00 00 02 02 61 62 62 62 62 62 97 98 97 97 97 62 62 62 62 52 50 02 02 37 02 02 02 02 02 02 02 37 02 02 02 02 02 02 02 02 02 02 02 02 02 02 02 02 02 95 95 35 95 95 95 95 35 02 02 02 02 02 02 02 96 96 96 96 96 02 96 02 96 96 96 02 61 62 62 62 63 02 02 02 02 02 02 02 02 02 02 02 02 02 02 02 02 96 96 96 96 96 00 00 00 00 00
00 00 00 00 00 02 02 61 62 62 62 62 97 97 97 97 62 62 62 62 62 62 62 63 02 02 37 02 02 02 02 02 02 02 37 02 02 02 02 02 02 02 02 02 02 02 02 02 02 02 02 02 02 95 35 02 02 02 95 35 02 02 02 02 02 02 02 96 96 02 02 02 02 02 02 02 96 02 02 61 62 62 97 63 02 02 02 01 02 02 02 02 02 02 02 02 02 02 02 02 96 96 96 96 96 00 00 00 00 00
00 00 00 00 00 01 02 61 62 62 62 62 97 98 98 98 98 98 62 62 62 62 62 63 01 02 37 02 02 02 02 02 02 02 37 02 02 02 02 02 02 02 02 02 02 02 02 02 02 02 02 02 02 02 35 02 02 01 02 35 02 02 02 02 02 02 02 02 02 02 02 02 02 02 02 02 96 02 02 61 62 62 97 63 02 02 02 01 02 02 02 02 33 34 02 02 02 02 02 02 02 96 96 96 96 00 00 00 00 00
00 00 00 00 00 02 01 71 64 62 62 62 62 98 98 98 98 62 62 62 62 65 72 73 01 02 37 02 02 02 02 02 02 02 37 02 02 02 02 02 02 02 02 02 02 02 02 02 02 02 02 02 02 02 35 02 02 01 01 35 02 02 02 02 02 02 02 02 02 02 02 02 02 02 02 02 02 02 02 61 62 62 97 63 02 02 02 01 02 02 02 02 41 42 02 02 02 02 02 02 02 96 96 96 96 00 00 00 00 00
00 00 00 00 00 02 01 02 71 72 64 62 62 62 62 62 98 62 62 65 72 73 02 02 02 02 37 02 02 02 02 02 02 02 37 02 02 02 02 02 02 02 02 02 02 02 02 02 02 02 02 02 02 02 35 02 02 02 02 35 02 02 02 02 01 01 01 02 02 02 02 02 02 02 02 02 02 02 02 61 62 62 62 63 02 02 02 01 02 02 02 02 02 02 02 02 02 02 02 02 02 96 96 96 96 00 00 00 00 00
00 00 00 00 00 02 01 02 02 02 71 64 62 62 62 62 62 62 62 63 02 02 02 02 02 02 37 02 02 02 02 02 02 02 37 02 02 02 02 02 02 02 02 02 02 02 02 02 02 02 02 02 02 02 35 02 02 02 02 35 02 02 02 02 01 01 01 02 02 01 01 02 02 02 02 02 02 02 02 61 62 62 62 63 02 02 02 02 02 02 02 02 02 02 02 02 02 02 02 02 02 96 96 96 96 00 00 00 00 00
00 00 00 00 00 44 44 44 44 38 02 71 72 72 72 72 72 72 72 73 02 02 02 02 02 02 37 02 02 02 02 02 02 02 37 02 02 02 02 02 02 02 02 02 02 02 02 02 02 02 02 02 02 02 35 02 02 02 02 35 02 02 02 02 02 01 01 02 01 02 01 01 02 02 02 02 02 02 02 61 62 62 62 63 02 02 02 01 02 02 02 02 02 02 02 02 02 02 02 02 02 02 96 96 96 00 00 00 00 00
00 00 00 00 00 95 95 95 95 35 02 02 02 02 02 58 02 02 02 02 02 02 02 02 02 02 37 02 02 02 02 02 02 02 37 02 02 02 02 02 02 02 02 02 02 02 02 02 02 02 02 02 02 02 35 02 02 01 01 35 02 02 02 02 01 01 02 02 01 01 01 01 01 01 01 01 01 02 02 61 62 62 62 63 02 02 02 02 02 02 02 02 02 02 02 02 02 02 02 02 02 02 96 96 96 00 00 00 00 00
00 00 00 00 00 95 95 95 95 43 44 44 38 02 02 58 02 02 02 39 44 44 44 44 44 44 45 02 02 02 02 02 02 02 37 02 02 02 02 02 02 02 02 02 02 02 02 02 02 02 02 02 02 02 35 02 02 01 01 35 02 02 02 02 01 01 02 02 02 01 01 01 01 01 01 01 01 02 02 61 62 62 62 63 02 02 02 02 02 02 02 02 02 02 02 02 02 02 02 02 02 02 96 96 96 00 00 00 00 00
00 00 00 00 00 95 95 95 95 02 02 02 35 02 02 58 02 02 02 37 02 02 02 02 02 02 02 02 02 02 02 02 02 02 37 02 02 02 02 02 02 02 02 02 02 02 02 02 02 02 02 02 02 02 35 02 02 01 01 35 02 02 02 02 02 02 02 02 02 02 01 01 01 01 01 01 01 02 02 61 62 62 62 63 02 02 02 02 02 02 02 02 02 02 02 02 02 02 02 02 02 02 96 96 96 00 00 00 00 00
00 00 00 00 00 95 95 95 02 02 02 02 35 02 02 58 02 02 02 37 02 02 01 01 01 02 02 02 02 02 02 02 02 02 37 02 02 02 02 02 02 02 02 02 02 02 02 02 02 02 02 02 02 02 35 02 02 01 02 43 44 44 38 02 02 02 02 02 02 02 02 02 02 02 02 02 02 02 02 61 62 62 62 63 02 02 02 02 02 02 02 02 02 02 02 02 02 02 02 02 02 02 96 96 96 00 00 00 00 00
00 00 00 00 00 95 95 95 02 02 02 02 43 44 44 85 44 44 44 45 02 48 49 49 49 49 49 49 50 02 02 02 02 02 37 02 02 02 02 02 02 02 02 02 02 02 02 02 02 02 02 02 02 02 35 02 02 01 01 02 02 02 35 02 02 02 02 02 02 02 02 01 01 01 01 01 01 01 01 61 62 62 97 63 02 02 02 02 02 02 02 02 02 02 02 02 02 02 02 02 02 02 96 96 96 00 00 00 00 00
00 00 00 00 00 95 95 02 02 02 02 02 02 02 02 58 02 02 02 02 02 61 62 97 62 62 62 62 63 02 02 02 02 02 37 02 02 02 02 02 02 02 02 02 02 02 02 02 02 02 02 02 02 02 35 02 02 02 02 02 02 02 35 02 02 02 02 02 02 02 02 02 02 02 02 02 48 49 49 51 62 62 97 52 50 02 02 01 02 01 02 02 02 02 02 02 02 02 02 02 02 02 96 96 96 00 00 00 00 00
00 00 00 00 00 95 95 02 02 02 25 02 02 02 02 58 02 02 02 02 01 61 97 97 65 72 72 72 73 02 02 02 02 02 37 02 02 02 02 02 02 02 02 02 02 02 02 02 02 02 02 02 02 02 40 02 02 02 02 02 02 02 43 44 44 38 02 02 02 02 02 02 02 02 02 48 51 62 62 62 62 97 97 62 52 49 50 02 02 01 02 01 02 02 02 02 02 02 02 02 02 02 96 96 96 00 00 00 00 00
00 00 00 00 00 95 95 02 02 02 03 02 02 02 02 58 02 02 02 48 78 51 98 98 63 02 02 02 02 02 02 02 02 02 37 02 02 02 02 02 02 02 02 02 02 02 02 02 02 02 02 02 02 02 40 02 02 02 02 02 02 02 02 02 02 40 02 02 02 02 48 49 49 49 49 51 62 62 62 62 97 97 62 62 62 62 52 50 02 02 02 01 02 02 02 02 02 02 02 02 02 96 96 96 96 00 00 00 00 00
00 00 00 00 00 95 95 02 02 02 11 02 02 02 02 84 77 77 77 59 79 79 98 79 80 02 02 39 44 44 44 44 44 44 45 02 02 02 02 02 02 02 02 02 02 02 02 02 02 02 02 02 02 02 40 02 02 02 02 02 02 02 02 02 02 35 02 02 01 02 61 62 62 62 62 62 62 62 62 97 97 97 98 98 98 62 62 52 49 50 02 02 02 02 02 02 02 02 02 02 96 96 96 96 96 00 00 00 00 00
00 00 00 00 00 95 95 02 02 02 11 02 02 02 02 02 02 02 02 71 82 82 82 82 83 02 02 37 02 02 02 02 02 02 02 02 02 02 02 02 02 02 02 02 02 02 02 02 02 02 02 02 02 02 35 02 02 02 02 02 02 02 02 02 02 43 44 44 38 02 61 62 62 62 62 62 97 97 62 97 97 62 97 98 98 98 62 98 98 52 50 02 02 02 02 02 02 02 02 02 96 96 96 96 96 00 00 00 00 00
00 00 00 00 00 95 02 02 02 02 11 02 02 02 02 02 02 02 02 02 02 02 02 02 02 02 02 37 02 02 01 01 01 02 02 02 02 02 02 02 02 02 02 02 02 02 02 02 02 02 02 02 02 02 43 44 44 38 02 02 02 02 02 02 02 02 02 02 35 02 61 62 62 62 97 97 97 97 97 97 97 97 97 98 98 98 98 98 62 62 63 02 02 02 02 02 02 02 02 02 96 96 96 96 96 00 00 00 00 00
00 00 00 00 00 44 44 38 02 02 11 02 02 02 39 44 44 44 44 44 44 44 44 44 44 44 44 45 02 01 01 02 02 01 01 01 02 02 02 02 02 02 02 02 02 02 02 02 02 02 02 02 02 02 02 02 02 35 02 02 02 02 02 02 02 02 02 02 35 01 61 62 62 62 62 62 62 97 97 97 97 97 97 98 98 98 98 62 62 62 52 49 49 86 49 49 49 49 49 49 49 49 49 49 49 00 00 00 00 00
00 00 00 00 00 95 95 35 02 02 11 02 02 02 37 02 02 02 02 02 02 02 02 02 02 02 02 02 02 01 01 02 01 01 02 01 02 02 02 02 02 02 02 02 02 02 02 02 02 02 02 02 02 02 02 02 02 35 02 02 02 02 02 02 02 02 02 02 35 01 61 62 62 62 62 62 62 62 98 98 98 97 98 97 97 98 98 62 62 62 65 72 72 88 72 72 72 72 72 72 72 72 72 72 72 00 00 00 00 00
00 00 00 00 00 95 95 35 02 02 11 02 02 02 37 02 02 01 01 01 02 02 02 02 02 02 02 02 02 02 02 02 02 02 02 02 02 02 02 02 02 02 02 02 02 02 02 02 02 02 02 02 02 02 02 02 02 43 44 44 38 02 02 02 02 02 02 02 40 01 71 64 62 62 62 62 62 62 62 98 98 98 98 98 98 98 98 62 62 62 63 02 02 02 02 02 02 02 02 02 96 96 96 96 96 00 00 00 00 00
00 00 00 00 00 95 95 43 44 44 47 44 44 44 45 02 01 01 02 02 01 01 02 02 02 02 02 02 02 02 02 02 02 02 02 02 02 02 02 02 02 02 02 02 02 02 02 02 02 02 02 02 02 02 02 02 02 02 02 02 35 02 02 02 02 02 02 02 40 01 02 71 72 72 72 64 62 62 62 62 62 62 62 62 62 62 62 62 62 62 63 02 02 02 02 02 02 02 02 02 96 96 96 96 96 00 00 00 00 00
00 00 00 00 00 95 95 95 95 95 11 02 02 02 02 02 01 01 02 01 01 02 02 02 02 02 02 02 02 02 02 02 02 02 02 02 02 02 02 02 02 02 02 02 02 02 02 02 02 02 02 02 02 02 02 02 02 02 02 02 35 02 02 02 02 02 02 02 40 02 02 01 02 02 02 71 64 62 62 62 62 62 62 62 62 62 62 62 65 72 73 02 02 02 02 02 02 02 02 02 96 96 96 96 96 00 00 00 00 00
00 00 00 00 00 95 95 95 95 95 11 02 02 02 02 02 02 02 02 02 02 02 02 02 02 02 02 02 02 02 02 02 05 06 06 06 06 06 06 06 06 06 06 06 07 02 02 02 02 02 02 02 02 02 02 02 02 02 02 02 43 44 44 38 02 02 02 02 35 02 02 02 02 02 02 02 71 72 72 72 72 72 72 72 72 72 72 72 73 02 02 02 02 02 02 02 02 02 02 02 96 96 96 96 96 00 00 00 00 00
00 00 00 00 00 95 95 95 95 95 11 02 02 02 02 02 02 02 02 05 06 06 06 06 06 06 06 06 06 06 06 06 08 15 15 15 15 15 15 15 15 15 15 15 15 06 06 07 02 02 02 02 02 02 02 02 02 02 02 02 02 02 02 35 02 02 02 02 35 02 02 02 02 02 02 02 02 02 02 02 02 02 02 02 01 01 01 02 02 02 02 02 02 02 02 02 02 02 02 02 96 96 96 96 96 00 00 00 00 00
00 00 00 00 00 95 95 95 95 95 11 02 02 02 02 02 02 05 06 08 15 15 15 15 15 15 15 15 15 15 15 15 15 15 15 15 15 15 15 15 15 15 15 15 15 15 15 15 06 07 02 02 02 02 02 02 02 02 02 02 02 02 02 35 02 02 02 02 43 44 44 44 44 44 44 44 44 38 02 02 02 02 02 02 01 02 02 02 02 02 02 02 02 02 02 02 02 02 02 02 02 96 96 96 96 00 00 00 00 00
00 00 00 00 00 95 95 95 95 95 20 27 27 27 27 06 06 08 15 15 15 15 15 15 15 15 15 15 15 15 15 15 15 15 15 15 15 15 15 15 15 15 15 15 15 15 15 15 15 15 06 07 02 02 02 02 02 01 02 02 02 02 02 43 44 44 44 44 44 44 44 44 38 02 02 02 02 35 02 02 02 02 02 01 02 02 02 02 02 02 02 02 02 02 02 02 02 02 02 02 02 96 96 96 96 00 00 00 00 00
00 00 00 00 00 95 95 95 95 95 02 02 02 05 06 15 15 15 15 15 15 15 15 15 15 15 15 15 15 15 15 15 15 15 15 15 15 15 15 15 15 15 15 15 15 15 15 15 15 15 15 15 06 06 07 02 02 02 02 02 02 02 02 02 02 02 02 02 02 02 02 02 35 02 02 02 02 35 02 02 02 02 02 02 02 02 02 02 02 02 02 02 02 02 02 02 02 02 02 02 02 96 96 96 96 00 00 00 00 00
00 00 00 00 00 95 95 95 95 95 02 05 06 08 15 15 15 15 15 15 15 15 15 15 15 15 15 15 15 15 15 15 15 15 15 15 15 15 15 15 15 15 15 15 15 15 15 15 15 15 15 15 15 15 15 06 06 07 02 02 02 02 02 02 02 02 02 02 02 02 02 02 43 44 44 44 44 38 02 02 02 02 02 02 02 02 02 02 02 02 02 02 02 02 02 02 02 02 02 02 02 96 96 96 96 00 00 00 00 00
00 00 00 00 00 95 95 02 02 05 06 08 15 15 15 15 15 15 15 15 15 15 15 15 15 15 15 15 15 15 15 15 15 15 15 15 15 15 15 15 15 15 15 15 15 15 15 15 15 15 15 15 15 15 15 15 15 09 06 06 06 07 02 02 02 02 02 02 02 02 02 02 02 02 02 02 02 35 02 02 02 02 02 02 02 02 02 02 02 02 02 02 02 02 02 02 02 02 02 02 02 96 96 96 96 00 00 00 00 00
00 00 00 00 00 95 02 05 06 08 15 15 15 15 15 15 15 15 15 15 15 15 15 15 15 15 15 15 15 15 15 15 15 15 15 15 15 15 15 15 15 15 15 15 15 15 15 15 15 15 15 15 15 15 15 15 15 15 15 15 15 09 07 02 02 02 02 02 02 02 02 02 02 02 02 02 02 35 02 02 02 02 02 02 02 02 02 02 02 02 02 02 02 02 02 02 02 02 02 02 02 96 96 96 96 00 00 00 00 00
00 00 00 00 00 02 05 93 93 93 15 15 15 15 93 93 15 15 15 15 15 15 15 15 15 15 15 15 15 15 15 15 15 15 15 15 15 15 15 15 15 15 15 15 15 15 15 15 15 15 15 15 15 15 15 15 15 15 15 15 15 15 09 06 06 07 02 02 02 02 02 02 02 02 02 02 02 43 44 44 44 44 44 38 02 02 02 02 02 02 02 02 02 02 02 02 02 02 02 02 02 96 96 96 96 00 00 00 00 00
00 00 00 00 00 93 93 93 93 93 15 93 93 93 93 93 15 93 15 15 15 15 15 15 15 15 15 15 15 15 15 15 15 15 15 15 15 15 15 15 15 15 15 15 15 15 15 15 15 15 15 15 15 15 15 15 15 15 15 15 15 15 15 15 15 09 06 06 07 02 02 02 02 02 02 02 02 02 02 02 02 02 02 35 02 02 02 02 02 02 02 02 02 02 02 02 02 02 02 02 02 02 96 96 96 00 00 00 00 00
00 00 00 00 00 93 93 93 93 93 93 93 93 93 93 93 93 93 15 15 15 15 15 15 15 15 15 15 15 15 15 15 15 15 15 15 15 15 15 15 15 15 15 15 15 15 15 15 15 15 15 15 15 15 15 15 15 15 15 15 15 15 15 15 15 15 15 15 09 06 06 07 02 02 02 02 02 02 02 02 02 02 02 35 02 02 02 02 02 02 02 02 02 02 02 02 02 02 02 02 02 02 96 96 96 00 00 00 00 00
00 00 00 00 00 93 93 93 93 93 93 93 93 93 93 93 93 93 15 15 15 15 15 15 15 15 15 15 53 54 54 54 54 86 54 54 54 54 54 55 15 15 15 15 15 15 15 15 15 15 15 15 15 15 15 15 15 15 15 15 15 15 15 15 15 15 15 15 15 15 15 09 06 07 02 02 02 02 02 02 02 02 02 35 02 01 01 02 02 02 02 02 02 02 02 02 02 02 02 02 02 02 96 96 96 00 00 00 00 00
00 00 00 00 00 93 93 93 93 93 93 93 93 93 93 93 93 15 15 15 15 15 15 15 15 53 54 54 56 67 67 67 67 87 67 67 67 67 67 57 54 54 54 55 15 15 15 15 15 15 15 15 15 15 15 15 15 15 15 15 15 15 15 15 15 15 15 15 15 15 15 15 15 09 06 07 02 02 02 02 02 02 02 43 44 44 44 44 44 38 02 02 02 02 02 02 02 02 02 02 02 02 96 96 96 00 00 00 00 00
00 00 00 00 00 93 93 93 93 93 93 93 93 93 93 93 15 15 15 15 15 15 53 54 54 56 67 67 67 67 67 67 67 87 67 67 67 67 67 67 67 67 67 57 54 54 55 15 15 15 15 15 15 15 15 15 15 15 15 15 15 15 15 15 15 15 15 15 15 15 15 15 15 15 15 09 06 07 02 02 02 02 02 02 02 02 02 02 02 43 38 02 02 02 02 02 02 02 02 02 02 02 96 96 96 00 00 00 00 00
00 00 00 00 00 93 93 93 93 93 93 93 93 93 15 15 15 15 15 15 53 54 56 67 67 67 67 67 67 67 67 67 67 87 67 67 67 67 67 67 67 67 67 67 67 67 57 54 54 55 15 15 15 15 15 15 15 15 15 15 15 15 15 15 15 15 15 15 15 15 15 15 15 15 15 15 15 09 07 02 02 02 02 02 02 02 02 02 02 02 43 44 44 38 02 02 02 02 02 02 02 02 96 96 96 00 00 00 00 00
00 00 00 00 00 93 93 93 93 93 93 93 93 15 15 15 15 15 53 54 56 67 67 67 67 67 67 67 67 67 67 70 75 88 75 69 67 67 67 67 67 67 67 67 67 67 67 67 67 57 54 54 55 15 15 93 93 93 93 93 93 93 93 15 15 93 93 15 15 15 15 15 15 15 15 15 15 15 09 06 06 07 02 02 02 02 02 02 02 02 02 02 02 43 44 44 44 44 44 44 44 44 44 44 44 00 00 00 00 00
00 00 00 00 00 93 93 93 93 93 93 93 15 15 15 15 53 54 56 67 67 67 67 67 67 67 67 67 67 67 67 68 15 15 15 74 75 75 75 75 75 75 75 75 75 75 69 67 67 67 67 67 57 55 15 93 93 93 93 93 93 93 93 93 93 93 93 93 93 93 15 15 15 15 15 15 15 15 15 15 15 09 06 07 02 02 02 02 02 02 02 02 02 02 02 02 02 02 02 96 96 96 96 96 96 00 00 00 00 00
00 00 00 00 00 93 93 93 93 93 93 15 15 15 15 53 56 67 67 67 67 67 67 67 67 67 67 67 67 67 67 68 15 15 15 15 15 15 15 15 15 15 15 15 15 15 74 75 69 67 67 67 67 57 54 54 55 15 93 93 93 93 93 93 93 93 93 93 93 93 93 93 15 15 15 15 15 15 15 15 15 15 15 09 07 02 02 02 02 02 02 02 02 02 02 02 02 02 02 02 96 96 96 96 96 00 00 00 00 00
00 00 00 00 00 93 93 93 93 93 15 15 53 54 54 56 67 67 67 67 67 67 67 67 67 67 67 67 67 67 70 76 15 15 15 15 15 15 15 15 15 15 15 15 15 15 15 15 74 75 75 69 67 67 67 67 57 54 54 54 55 15 93 93 93 93 93 93 93 93 93 93 93 93 15 15 15 15 15 15 15 15 15 15 09 06 07 02 02 02 02 02 02 02 02 02 02 02 02 02 02 96 96 96 96 00 00 00 00 00
00 00 00 00 00 93 93 93 93 15 15 53 56 67 67 67 67 67 67 67 67 67 67 67 67 67 67 67 70 75 76 15 15 15 15 15 15 15 15 15 15 15 15 15 15 15 15 15 15 15 15 74 75 75 69 67 67 67 67 67 57 54 54 55 15 93 93 93 93 93 93 93 15 93 93 93 15 15 15 15 15 15 15 15 15 15 16 02 02 02 02 02 02 02 02 02 02 02 02 02 02 96 96 96 96 00 00 00 00 00
00 00 00 00 00 93 93 93 93 15 53 56 67 67 67 67 67 67 67 67 67 67 67 67 67 70 75 75 76 15 15 15 15 15 15 15 15 15 15 15 15 15 15 15 15 15 15 15 15 15 15 15 15 15 74 75 69 67 67 67 67 67 67 57 54 54 55 15 93 93 93 93 93 93 93 93 93 93 93 15 15 15 15 15 15 15 09 07 02 02 02 02 02 02 02 02 02 02 02 02 02 02 96 96 96 00 00 00 00 00
00 00 00 00 00 93 93 15 15 53 56 67 67 67 67 67 67 67 67 67 67 67 70 75 75 76 15 15 15 15 15 15 15 15 15 15 15 15 15 15 15 15 15 15 15 15 15 15 15 15 15 15 15 15 15 15 74 69 67 67 67 67 67 67 67 67 57 54 55 15 15 15 15 93 93 93 93 93 93 93 93 15 15 15 15 15 15 09 06 07 02 02 02 02 02 02 02 02 02 02 02 02 96 96 96 00 00 00 00 00
00 00 00 00 00 93 53 54 54 56 67 67 67 67 67 67 67 67 67 70 75 75 93 93 15 15 15 15 15 15 15 15 15 23 23 23 17 15 15 15 15 15 15 15 15 15 15 15 15 15 15 15 15 15 15 15 15 74 69 67 67 67 67 67 67 67 67 67 57 54 54 55 15 15 93 93 93 93 93 93 93 93 93 93 15 15 15 15 15 09 06 06 07 02 02 02 02 02 02 02 02 96 96 96 96 00 00 00 00 00
00 00 00 00 00 00 00 00 00 00 00 00 00 00 00 00 00 00 00 00 00 00 00 00 00 00 00 00 00 00 00 00 00 00 00 00 00 00 00 00 00 00 00 00 00 00 00 00 00 00 00 00 00 00 00 00 00 00 00 00 00 00 00 00 00 00 00 00 00 00 00 00 00 00 00 00 00 00 00 00 00 00 00 00 00 00 00 00 00 00 00 00 00 00 00 00 00 00 00 00 00 00 00 00 00 00 00 00 00 00
00 00 00 00 00 00 00 00 00 00 00 00 00 00 00 00 00 00 00 00 00 00 00 00 00 00 00 00 00 00 00 00 00 00 00 00 00 00 00 00 00 00 00 00 00 00 00 00 00 00 00 00 00 00 00 00 00 00 00 00 00 00 00 00 00 00 00 00 00 00 00 00 00 00 00 00 00 00 00 00 00 00 00 00 00 00 00 00 00 00 00 00 00 00 00 00 00 00 00 00 00 00 00 00 00 00 00 00 00 00
00 00 00 00 00 00 00 00 00 00 00 00 00 00 00 00 00 00 00 00 00 00 00 00 00 00 00 00 00 00 00 00 00 00 00 00 00 00 00 00 00 00 00 00 00 00 00 00 00 00 00 00 00 00 00 00 00 00 00 00 00 00 00 00 00 00 00 00 00 00 00 00 00 00 00 00 00 00 00 00 00 00 00 00 00 00 00 00 00 00 00 00 00 00 00 00 00 00 00 00 00 00 00 00 00 00 00 00 00 00
00 00 00 00 00 00 00 00 00 00 00 00 00 00 00 00 00 00 00 00 00 00 00 00 00 00 00 00 00 00 00 00 00 00 00 00 00 00 00 00 00 00 00 00 00 00 00 00 00 00 00 00 00 00 00 00 00 00 00 00 00 00 00 00 00 00 00 00 00 00 00 00 00 00 00 00 00 00 00 00 00 00 00 00 00 00 00 00 00 00 00 00 00 00 00 00 00 00 00 00 00 00 00 00 00 00 00 00 00 00
00 00 00 00 00 00 00 00 00 00 00 00 00 00 00 00 00 00 00 00 00 00 00 00 00 00 00 00 00 00 00 00 00 00 00 00 00 00 00 00 00 00 00 00 00 00 00 00 00 00 00 00 00 00 00 00 00 00 00 00 00 00 00 00 00 00 00 00 00 00 00 00 00 00 00 00 00 00 00 00 00 00 00 00 00 00 00 00 00 00 00 00 00 00 00 00 00 00 00 00 00 00 00 00 00 00 00 00 00 00
