00 00 00 00 00 91 91 91 91 91 91 91 91 91 91 91 91 91 91 91 91 91 91 91 91 91 91 91 91 91 91 91 91 91 91 91 91 91 91 91 91 91 91 91 91 91 91 91 91 91 91 91 91 91 91 91 91 91 91 91 91 91 91 91 91 91 91 91 91 91 91 91 91 91 91 91 91 91 91 91 91 91 91 91 91 91 91 91 91 91 91 91 91 91 91 91 91 91 91 91 91 91 91 91 91 00 00 00 00 00
00 00 00 00 00 91 91 91 91 91 91 91 91 91 91 91 91 91 91 91 91 91 92 92 92 92 92 92 91 91 92 92 92 91 91 91 91 91 91 91 91 91 91 91 91 91 91 91 91 91 91 91 91 91 91 91 91 91 91 91 91 91 91 91 91 91 91 91 91 91 91 91 91 91 91 91 91 91 91 91 91 91 91 91 91 91 91 91 91 91 91 91 91 91 91 91 91 91 91 91 91 91 91 91 91 00 00 00 00 00
00 00 00 00 00 91 91 92 92 92 92 92 92 92 92 92 92 92 92 92 92 92 92 91 91 92 92 92 91 91 92 92 92 92 92 92 92 92 92 92 92 92 92 92 92 92 92 92 92 92 92 92 92 92 92 91 91 92 92 92 92 92 92 92 92 92 92 92 92 92 92 92 92 92 92 92 92 92 92 92 92 92 92 92 91 91 92 92 92 92 92 92 92 92 92 92 92 92 92 92 92 92 92 91 91 00 00 00 00 00
00 00 00 00 00 91 92 92 92 92 92 92 92 92 92 92 92 92 92 92 92 92 92 91 92 92 92 92 92 92 92 92 92 92 92 92 92 92 92 92 92 92 92 92 92 92 92 92 92 92 92 92 92 92 92 91 91 92 92 92 92 92 92 92 92 92 92 92 92 92 92 92 92 92 92 92 92 92 92 92 92 92 92 92 91 91 92 92 92 92 92 92 92 92 92 92 92 92 92 92 92 92 92 91 91 00 00 00 00 00
00 00 00 00 00 91 91 92 92 92 92 91 91 91 91 91 91 91 91 91 92 92 92 91 92 92 92 92 92 92 92 92 92 92 92 92 92 92 92 92 92 92 92 92 92 92 92 92 92 92 92 92 92 92 92 91 91 92 92 92 92 92 92 92 92 92 92 92 92 92 92 92 92 92 92 92 92 92 92 92 92 92 92 92 91 91 92 92 92 92 92 92 92 92 92 92 92 92 92 92 92 92 92 91 91 00 00 00 00 00
00 00 00 00 00 91 91 91 92 92 92 91 92 92 92 92 92 92 92 92 92 92 92 91 92 92 92 92 92 92 92 92 92 92 92 92 92 92 92 92 92 92 92 92 92 92 92 92 92 92 92 92 92 92 92 91 91 92 92 92 92 92 92 92 92 92 92 92 92 92 92 92 92 92 92 91 91 92 92 92 92 92 92 92 91 91 92 92 91 91 92 92 92 91 91 91 91 91 92 92 92 92 92 91 91 00 00 00 00 00
00 00 00 00 00 91 91 92 92 92 92 92 92 92 92 92 92 91 91 91 91 91 91 91 92 92 91 91 91 91 91 91 91 92 92 91 91 91 91 91 91 91 91 91 91 91 92 92 92 92 92 92 92 92 92 91 91 92 92 92 92 92 92 91 91 92 92 92 92 92 92 92 92 92 92 91 91 92 92 92 92 92 92 92 91 91 92 92 91 91 92 92 92 91 91 91 91 91 92 92 92 92 92 91 91 00 00 00 00 00
00 00 00 00 00 91 92 92 92 92 92 92 92 92 92 92 92 91 91 91 91 91 91 91 91 91 91 91 91 91 91 91 91 92 91 91 92 91 91 91 91 91 91 91 91 91 92 92 92 92 92 92 92 92 92 91 91 92 92 92 92 92 92 91 91 92 92 92 92 92 92 92 91 91 91 91 91 91 92 92 92 92 92 92 91 91 92 92 91 91 92 92 92 92 92 92 91 91 92 92 92 92 92 91 91 00 00 00 00 00
00 00 00 00 00 91 91 92 92 91 91 92 92 92 92 92 92 92 92 92 92 92 92 91 91 92 92 92 92 92 92 92 92 92 92 92 92 91 92 92 92 92 92 92 92 92 92 92 92 92 92 92 92 92 92 91 91 92 92 92 92 92 92 91 91 92 92 92 92 92 92 92 91 91 91 91 91 91 92 92 92 92 92 92 91 91 92 92 91 91 92 92 92 92 92 92 91 92 92 92 92 92 92 91 91 00 00 00 00 00
00 00 00 00 00 91 91 92 92 91 91 92 92 92 92 92 92 92 92 92 92 92 92 91 91 92 92 92 92 92 92 92 92 92 92 92 92 91 91 91 91 91 92 92 91 91 92 92 91 91 92 92 92 92 92 91 91 92 92 92 92 92 92 91 91 92 92 92 92 92 92 92 91 91 92 92 92 92 92 92 92 92 92 92 91 91 92 92 91 91 92 92 92 92 92 92 91 92 92 92 92 92 92 91 91 00 00 00 00 00
00 00 00 00 00 91 91 92 92 91 91 92 92 92 92 92 92 92 91 91 92 92 92 91 91 92 92 92 92 92 92 92 92 92 92 92 92 91 91 91 91 91 92 92 91 91 92 92 91 91 92 92 92 92 92 91 91 91 91 91 91 91 91 91 91 91 91 91 91 91 91 91 91 91 92 92 92 92 92 92 92 92 92 92 91 91 92 92 91 91 92 91 91 91 91 91 91 92 92 91 91 92 92 91 91 00 00 00 00 00
00 00 00 00 00 91 91 92 92 91 91 92 92 92 92 92 92 92 91 91 92 92 92 92 91 92 92 92 92 92 92 92 92 92 92 92 92 91 92 92 91 91 92 92 91 91 92 92 91 91 92 92 92 92 92 91 91 91 91 91 91 91 91 91 91 91 91 91 91 91 91 91 91 91 92 92 92 92 92 92 92 92 92 92 91 91 92 92 91 91 92 92 92 92 92 92 91 91 91 91 91 92 92 91 91 00 00 00 00 00
00 00 00 00 00 91 91 92 92 91 91 91 91 91 92 92 92 92 92 92 92 92 92 92 91 92 92 92 92 92 92 92 92 92 92 92 92 91 92 92 92 91 92 92 91 91 92 92 91 91 92 92 92 92 92 92 92 92 92 92 92 92 92 92 92 92 92 92 92 92 92 92 92 92 92 92 92 92 92 92 92 92 92 92 91 91 92 92 91 91 92 92 92 92 92 92 92 92 92 92 92 92 92 91 91 00 00 00 00 00
00 00 00 00 00 91 91 92 92 91 91 91 91 91 92 92 92 92 92 92 92 92 92 92 91 92 92 91 91 91 91 91 92 92 92 92 92 91 92 92 92 91 92 92 91 91 92 92 91 91 92 92 92 92 92 92 92 92 92 92 92 91 92 92 92 92 92 92 92 92 92 92 92 92 92 92 92 92 92 92 92 92 92 92 91 91 92 92 91 91 92 92 92 92 92 92 92 92 92 92 92 92 92 91 91 00 00 00 00 00
00 00 00 00 00 91 91 92 92 91 91 92 92 91 91 92 92 92 92 92 92 92 92 91 91 92 92 91 91 91 91 91 91 91 91 91 91 91 92 92 92 91 92 92 91 91 92 92 91 91 92 92 92 92 92 92 92 92 92 92 92 91 91 91 91 91 92 92 92 92 92 92 92 92 92 92 92 92 92 91 91 91 91 91 91 91 92 92 91 91 91 91 91 91 91 91 91 91 91 92 92 92 92 91 91 00 00 00 00 00
00 00 00 00 00 91 91 92 92 91 91 92 92 91 91 92 92 92 92 92 92 92 92 91 91 92 92 92 92 92 92 92 92 92 92 92 92 92 92 92 92 91 92 92 91 91 92 92 91 91 92 92 92 92 92 92 92 92 92 92 92 92 91 91 91 91 91 91 91 91 91 91 92 92 92 92 92 92 92 91 91 91 91 91 91 91 92 92 91 91 91 91 91 91 92 92 92 92 91 92 92 92 92 91 91 00 00 00 00 00
00 00 00 00 00 91 91 92 92 91 91 92 92 91 91 92 92 92 92 92 92 92 92 92 92 92 92 92 92 92 92 92 92 92 92 92 92 92 92 92 92 91 92 92 91 91 92 92 91 91 91 91 91 91 91 91 91 91 91 92 92 92 92 92 91 91 91 91 91 91 91 91 91 91 92 92 92 92 92 92 92 92 92 92 92 92 92 92 92 92 92 92 92 92 92 92 92 92 91 92 92 92 92 91 91 00 00 00 00 00
00 00 00 00 00 91 91 92 92 91 91 92 92 91 91 92 92 92 92 92 92 92 91 91 91 91 91 91 91 91 91 91 91 92 92 92 92 92 92 92 92 91 92 92 91 91 92 92 91 91 91 91 91 91 91 91 91 91 91 92 92 92 92 92 92 92 92 92 92 92 92 91 91 91 91 91 91 92 92 92 92 92 92 92 92 92 91 91 92 92 92 92 92 91 91 92 92 92 91 92 92 92 92 91 91 00 00 00 00 00
00 00 00 00 00 91 91 92 92 92 92 92 92 92 92 92 92 92 92 92 92 92 92 92 92 92 92 92 92 92 92 91 92 92 92 91 91 92 92 92 92 91 92 92 91 91 92 92 92 92 92 92 92 92 92 92 92 92 92 92 92 92 92 92 92 92 92 92 92 92 92 92 92 92 92 92 92 92 92 92 92 92 92 92 92 92 92 92 92 92 92 92 92 91 91 91 92 92 91 92 92 92 92 91 91 00 00 00 00 00
00 00 00 00 00 91 91 92 92 92 92 92 92 92 92 92 92 92 92 91 91 91 91 91 91 91 91 91 91 92 92 91 92 92 92 91 91 91 91 91 91 91 92 92 91 91 92 92 92 92 92 92 92 92 92 92 92 92 92 92 92 92 92 92 92 92 92 92 92 92 92 92 92 92 92 92 92 92 92 92 92 92 92 92 92 92 92 92 92 92 92 92 92 92 91 91 92 92 91 92 92 92 92 91 91 00 00 00 00 00
00 00 00 00 00 91 91 92 92 92 91 91 91 91 91 91 92 92 92 91 92 92 91 91 91 91 91 91 91 92 92 91 92 92 92 91 91 92 92 92 92 92 92 92 91 91 92 92 92 92 92 91 91 91 91 91 91 91 91 91 91 91 92 92 91 91 91 91 91 91 91 91 91 91 91 91 91 92 92 91 91 91 91 91 91 91 91 91 91 91 92 92 92 92 91 91 92 92 91 92 92 92 92 91 91 00 00 00 00 00
00 00 00 00 00 91 91 92 92 92 92 92 92 92 92 92 92 92 92 91 92 92 92 92 92 92 92 92 92 92 92 91 92 92 92 92 92 92 92 92 92 92 92 91 91 91 92 92 92 92 92 91 92 92 91 91 91 91 91 91 91 91 92 92 91 91 91 91 91 91 91 91 91 91 91 91 91 92 92 91 91 91 91 91 91 92 92 92 91 91 92 92 92 91 91 92 92 92 91 92 92 92 92 91 91 00 00 00 00 00
00 00 00 00 00 91 92 92 92 92 92 92 92 92 92 92 92 92 92 91 91 92 92 92 92 92 92 92 92 92 92 92 92 92 92 92 92 92 92 92 92 92 92 91 91 92 92 92 92 92 92 91 92 92 92 92 92 92 92 92 92 92 92 92 92 92 92 91 91 92 92 92 92 92 92 92 92 92 92 92 92 92 92 92 92 92 92 92 91 91 92 92 92 91 91 92 92 91 91 92 92 92 92 91 91 00 00 00 00 00
00 00 00 00 00 91 92 91 91 91 91 91 91 91 91 91 92 92 92 91 91 92 92 92 92 92 92 92 92 92 92 92 92 92 92 91 91 92 92 92 92 92 91 91 91 92 92 92 92 92 92 91 92 92 92 92 92 92 92 92 92 92 92 92 92 92 92 91 91 92 92 92 92 92 92 92 92 92 92 92 92 92 92 92 92 92 92 92 91 91 92 92 92 91 91 92 92 91 91 92 92 92 92 91 91 00 00 00 00 00
00 00 00 00 00 91 92 91 91 91 91 91 91 91 91 91 92 92 92 91 91 92 92 92 92 92 92 92 91 91 91 91 92 92 92 91 91 92 92 92 92 92 91 91 91 92 92 92 92 92 92 91 92 92 91 91 91 91 92 92 92 92 92 92 92 92 92 91 91 92 92 92 92 92 92 92 92 92 92 92 92 92 92 92 92 92 92 92 91 91 92 92 92 91 91 92 92 91 91 92 92 92 92 91 91 00 00 00 00 00
00 00 00 00 00 91 92 92 92 92 92 92 92 92 91 91 92 92 92 91 91 92 92 92 92 92 92 92 91 92 92 91 92 92 92 91 92 92 92 92 92 92 92 91 92 92 92 92 92 92 92 91 91 91 91 91 91 92 92 92 92 92 92 92 92 92 92 92 91 92 92 92 91 91 91 91 91 91 91 92 92 92 92 92 92 92 92 92 91 91 92 92 92 91 91 92 92 91 91 92 92 92 92 91 91 00 00 00 00 00
00 00 00 00 00 91 91 92 92 92 92 92 92 92 91 91 92 92 92 91 91 92 92 92 92 92 92 92 92 92 92 91 92 92 92 91 92 92 92 92 92 92 92 92 92 92 92 92 92 92 92 92 92 92 92 92 91 92 92 92 92 92 92 92 92 92 92 92 91 92 92 92 91 91 91 91 91 91 91 92 92 92 92 92 92 92 92 92 91 91 92 92 92 91 91 92 92 91 91 92 92 92 92 91 91 00 00 00 00 00
00 00 00 00 00 91 91 92 92 91 91 91 92 92 91 91 92 92 92 91 91 92 92 92 92 92 92 92 92 92 92 91 92 92 92 91 92 92 92 92 92 92 92 92 92 92 92 92 92 92 92 92 92 92 92 92 91 92 92 91 91 91 91 92 92 92 92 92 91 92 92 92 92 92 92 92 92 92 92 92 92 92 92 92 92 92 92 92 91 91 92 92 92 91 92 92 92 91 91 91 91 91 91 91 91 00 00 00 00 00
00 00 00 00 00 91 91 92 92 92 92 91 92 92 91 91 92 92 92 91 92 92 92 92 92 92 92 92 92 92 92 91 92 92 92 91 92 92 92 92 92 92 92 92 92 92 92 92 92 92 92 92 92 92 92 92 91 91 91 91 91 91 91 91 91 91 91 91 91 92 92 92 92 92 92 92 92 92 92 92 92 92 92 92 92 92 92 92 91 91 92 92 92 91 92 92 92 91 91 91 91 91 91 91 91 00 00 00 00 00
00 00 00 00 00 91 91 92 92 92 92 91 92 92 91 91 91 91 91 91 92 92 91 91 91 91 92 92 92 92 92 91 91 92 92 91 91 91 91 91 92 92 92 92 92 92 91 91 91 91 91 91 91 92 92 92 92 92 91 91 92 92 92 92 92 92 92 92 92 92 92 92 92 92 91 91 91 91 91 91 91 91 92 92 92 92 92 92 91 91 92 92 92 92 92 92 92 92 92 92 92 92 92 91 91 00 00 00 00 00
00 00 00 00 00 91 91 92 92 92 92 91 92 92 91 91 91 91 91 91 91 91 91 91 91 91 91 91 91 91 91 91 91 91 91 91 91 91 91 91 92 92 92 92 92 92 91 92 92 91 92 92 91 92 92 92 92 92 91 91 92 92 92 92 92 92 92 92 92 92 92 92 92 92 91 92 92 91 91 91 91 91 92 92 92 92 92 92 91 91 92 92 92 92 92 92 92 92 92 92 92 92 92 91 91 00 00 00 00 00
00 00 00 00 00 91 91 92 92 92 92 91 92 92 92 92 92 92 92 92 92 92 92 92 92 92 92 92 92 92 92 92 92 92 92 92 92 92 92 92 92 92 92 92 92 92 91 92 92 92 92 92 91 92 92 92 92 92 91 91 92 92 92 92 92 92 92 92 92 92 92 92 92 92 91 92 92 92 92 92 92 92 92 92 92 92 92 92 91 91 91 91 91 92 92 92 92 92 92 92 92 92 92 91 91 00 00 00 00 00
00 00 00 00 00 91 91 91 91 91 92 91 91 91 91 92 92 92 92 92 92 92 92 92 92 92 92 92 92 92 92 92 92 92 92 92 92 92 92 92 92 92 92 92 92 92 91 91 92 92 92 91 91 92 92 92 92 92 91 91 92 92 92 92 92 92 92 92 92 92 92 92 92 92 91 92 92 92 92 92 92 92 92 92 92 92 92 92 92 92 92 91 92 92 92 92 92 91 91 92 92 92 92 91 91 00 00 00 00 00
00 00 00 00 00 91 91 92 92 92 92 92 92 92 91 91 91 91 91 91 91 91 91 91 91 92 92 92 92 92 92 92 92 91 91 92 92 92 92 92 92 92 92 92 92 91 91 91 92 92 92 91 91 91 91 91 91 91 91 91 91 91 91 91 91 91 91 91 91 91 91 91 91 91 91 92 92 91 91 92 92 92 92 92 92 92 92 92 92 92 92 92 92 92 92 92 92 91 91 92 92 92 92 91 91 00 00 00 00 00
00 00 00 00 00 91 91 92 92 92 91 91 91 92 92 91 92 92 92 92 92 92 92 92 92 92 92 92 91 91 91 91 91 91 92 92 92 92 92 92 92 92 91 91 91 91 91 91 92 92 92 91 91 91 91 91 91 91 91 91 91 91 91 91 91 91 91 91 91 91 91 91 91 91 91 91 91 91 91 92 92 92 92 92 92 92 92 92 91 91 92 92 92 91 91 91 91 91 91 92 92 92 92 91 91 00 00 00 00 00
00 00 00 00 00 91 91 91 91 91 91 91 91 92 92 91 92 91 91 91 91 91 91 91 91 92 92 92 91 91 92 92 92 92 92 91 91 92 92 92 92 92 91 91 92 92 92 92 92 92 92 92 92 92 92 92 92 92 92 92 92 92 92 92 92 92 92 92 92 92 92 91 91 92 92 92 92 91 91 92 92 92 92 92 91 91 92 92 91 91 91 91 91 91 91 91 91 91 91 92 92 92 92 91 91 00 00 00 00 00
00 00 00 00 00 91 91 91 91 91 91 91 91 92 92 91 92 91 91 91 91 91 91 91 91 92 92 92 91 92 92 92 92 92 92 91 91 92 92 92 92 92 91 91 92 92 92 92 92 92 92 92 91 92 92 92 92 92 92 92 92 92 92 92 92 92 92 92 92 92 92 91 91 92 92 92 92 91 91 92 92 92 92 92 91 91 92 92 92 92 92 92 92 92 92 92 92 91 91 91 91 91 92 91 91 00 00 00 00 00
00 00 00 00 00 91 91 92 92 92 92 92 92 92 92 91 92 92 91 92 92 92 92 92 92 92 92 92 91 92 92 92 92 92 92 92 91 92 92 92 92 92 91 91 92 92 91 91 92 92 92 92 91 91 92 92 92 92 92 92 92 92 92 92 92 92 92 92 92 92 92 91 91 92 92 92 92 92 92 92 92 92 92 92 91 91 91 91 91 91 91 91 91 91 91 91 92 91 91 92 92 92 92 91 91 00 00 00 00 00
00 00 00 00 00 91 91 92 92 92 92 92 92 92 92 91 92 92 91 92 92 91 91 91 91 91 91 91 91 92 92 92 92 92 92 92 91 92 92 92 92 92 91 91 92 92 91 91 92 92 92 92 91 91 92 92 92 92 92 92 92 92 92 92 92 92 92 92 92 92 92 91 91 92 92 92 92 92 92 92 92 92 92 92 91 91 92 92 92 92 92 91 91 91 91 91 92 91 91 92 92 92 92 91 91 00 00 00 00 00
00 00 00 00 00 91 91 92 92 92 92 91 91 92 92 92 92 92 91 92 92 91 92 92 92 92 92 92 92 92 92 92 92 92 92 92 91 92 92 92 92 92 91 91 92 92 91 91 92 92 92 92 91 91 92 92 92 92 92 92 92 92 92 92 92 92 92 92 92 92 92 91 91 92 92 92 92 91 91 92 92 92 92 92 92 91 92 92 92 92 92 92 92 92 92 92 92 91 92 92 92 92 92 91 91 00 00 00 00 00
00 00 00 00 00 91 91 92 92 92 92 91 91 91 91 91 91 91 91 92 92 91 92 92 92 91 91 91 92 92 92 92 92 92 92 92 91 92 92 92 92 92 91 91 92 92 91 91 92 92 92 92 91 91 92 92 92 92 92 92 92 92 92 92 92 92 92 92 92 92 92 91 91 92 92 92 92 91 91 92 92 92 92 92 92 91 92 92 92 92 92 92 92 92 92 92 92 92 92 92 92 92 92 91 91 00 00 00 00 00
00 00 00 00 00 91 91 92 92 92 91 91 91 92 92 92 92 92 92 92 92 91 92 92 92 91 91 91 91 91 91 91 91 91 91 91 91 92 92 92 92 92 91 91 92 92 91 91 92 92 92 92 91 91 92 92 92 92 92 92 92 92 92 92 92 92 92 92 92 92 92 91 91 92 92 92 92 91 91 91 91 91 91 91 91 91 91 92 92 92 92 92 92 92 92 92 92 92 92 92 92 92 92 91 91 00 00 00 00 00
00 00 00 00 00 91 91 92 92 92 91 91 91 92 92 92 92 92 92 92 92 91 92 92 92 92 92 92 92 91 91 92 92 92 92 92 92 92 92 92 92 92 92 91 92 92 91 91 92 92 92 92 91 91 92 92 92 92 92 92 92 92 92 92 92 92 92 92 92 92 92 91 91 92 92 92 92 91 91 91 91 91 91 91 91 91 91 92 92 92 92 92 92 92 92 92 92 92 92 92 92 92 92 91 91 00 00 00 00 00
00 00 00 00 00 91 91 92 92 92 92 92 92 92 92 92 92 92 92 92 92 91 92 92 92 92 92 92 92 91 91 92 92 92 92 92 92 92 92 92 92 92 92 91 92 92 91 92 92 92 92 92 91 91 92 92 92 92 92 92 92 92 92 92 92 92 92 92 92 92 92 91 91 92 92 92 92 92 92 92 92 92 92 92 92 91 91 92 92 91 91 91 91 91 91 91 91 91 92 92 92 92 92 91 91 00 00 00 00 00
00 00 00 00 00 91 91 92 92 92 92 92 92 92 92 92 92 92 92 92 92 91 92 92 92 92 92 91 92 91 91 92 92 91 92 91 91 91 91 91 91 92 92 91 92 92 91 92 92 92 92 92 91 91 92 92 92 92 92 92 92 92 92 92 92 92 92 92 92 92 92 91 91 92 92 92 92 92 92 92 92 92 92 92 92 92 92 92 92 91 92 92 91 91 91 92 92 91 92 92 92 92 92 91 91 00 00 00 00 00
00 00 00 00 00 91 91 91 91 91 91 91 91 91 91 91 91 91 91 91 91 91 91 92 92 92 92 91 92 91 91 92 92 91 92 91 91 91 91 91 91 91 91 91 92 92 91 92 92 92 92 92 91 91 91 91 91 91 91 91 91 91 92 91 91 91 91 91 91 91 92 92 92 92 92 92 92 92 92 92 92 92 92 92 92 92 92 92 92 91 92 92 92 92 92 92 92 91 92 92 92 92 92 92 91 00 00 00 00 00
00 00 00 00 00 91 91 91 91 91 91 91 91 91 91 91 91 91 91 91 91 91 91 91 92 92 92 91 92 91 91 92 92 91 92 91 91 92 92 92 92 92 92 92 92 92 91 92 92 92 92 92 91 91 91 91 91 91 91 91 91 92 92 91 91 91 91 91 91 92 92 91 91 92 92 92 91 91 92 92 92 92 92 92 92 92 92 92 92 91 92 92 92 92 92 92 92 91 92 92 92 92 92 92 91 00 00 00 00 00
00 00 00 00 00 91 92 92 92 92 92 92 92 92 92 92 92 92 92 92 92 91 91 91 92 92 92 91 92 92 92 92 92 91 92 91 91 92 92 92 91 91 91 91 92 92 91 92 92 92 92 92 92 92 92 92 92 92 92 92 92 92 92 92 92 92 92 92 92 92 92 91 91 92 92 92 91 91 92 92 92 92 92 92 92 92 92 92 92 91 91 92 92 92 92 92 92 91 91 91 91 91 91 91 91 00 00 00 00 00
00 00 00 00 00 91 91 91 92 92 92 92 92 92 92 92 92 92 92 92 92 92 92 92 92 92 92 91 92 92 92 92 92 91 92 91 91 92 92 91 91 91 91 91 92 92 91 92 92 92 92 92 92 92 92 92 92 92 92 92 92 92 91 91 91 91 91 91 91 91 91 91 91 91 91 91 91 91 92 92 92 92 92 92 92 92 92 92 92 91 91 92 92 92 92 92 92 91 91 91 91 91 91 91 91 00 00 00 00 00
00 00 00 00 00 91 91 91 92 91 91 91 91 92 92 92 92 92 92 92 92 92 92 92 92 92 91 91 91 91 91 91 91 91 92 91 91 92 92 92 92 91 91 91 92 92 91 92 92 92 92 92 91 91 91 91 91 92 92 92 92 92 91 92 92 92 92 91 91 91 91 91 91 91 91 91 91 91 92 92 92 92 91 91 91 91 91 92 92 91 91 92 92 92 92 92 92 91 92 92 92 92 92 91 91 00 00 00 00 00
00 00 00 00 00 91 92 92 92 91 91 91 91 92 92 92 92 92 92 92 92 92 92 92 92 92 92 91 92 92 92 92 92 91 92 91 91 92 92 92 92 91 91 91 92 92 91 92 92 92 92 92 91 91 91 91 91 92 92 92 92 92 91 92 92 92 92 92 92 92 92 92 92 92 92 92 92 92 92 92 92 92 91 92 92 91 91 92 92 91 91 92 92 92 92 92 92 91 92 92 92 92 92 91 91 00 00 00 00 00
00 00 00 00 00 91 91 92 92 92 92 91 92 92 92 92 92 92 92 92 92 92 92 92 92 92 92 92 92 92 92 92 92 92 92 92 92 92 92 92 92 91 91 92 92 92 91 92 92 92 92 92 92 92 91 91 92 92 92 92 92 92 91 92 92 92 92 92 92 92 92 92 91 91 91 92 92 92 92 92 92 92 91 92 92 92 92 92 92 91 91 92 92 92 92 92 92 91 92 92 92 92 92 91 91 00 00 00 00 00
00 00 00 00 00 91 91 92 92 92 92 91 92 92 92 92 92 92 92 92 92 92 92 92 92 91 92 92 92 92 91 92 92 92 92 92 92 92 92 92 92 91 91 92 92 92 91 92 92 92 92 92 92 92 91 91 92 92 92 92 92 92 91 92 92 92 92 92 92 92 92 91 91 92 91 91 92 92 92 92 92 92 91 91 92 92 92 92 92 92 92 92 91 91 92 92 92 91 92 92 92 92 92 91 91 00 00 00 00 00
00 00 00 00 00 91 91 92 92 92 92 91 92 92 92 92 92 91 91 92 92 92 92 92 92 91 91 91 91 91 91 92 92 92 92 92 92 92 92 92 92 91 91 92 92 92 91 92 92 91 91 91 91 91 91 91 91 91 91 91 91 91 91 92 92 92 91 91 91 92 92 91 92 92 92 91 91 92 92 92 91 91 91 91 92 92 92 92 92 92 92 92 91 91 92 92 91 91 92 92 92 92 92 91 91 00 00 00 00 00
00 00 00 00 00 91 91 92 92 92 92 91 91 91 91 91 91 91 91 92 92 92 92 92 92 92 92 92 92 92 92 92 92 92 92 91 91 92 92 92 92 91 92 92 92 92 91 91 91 91 91 91 91 91 91 91 91 91 91 91 91 91 91 91 91 91 91 91 91 92 92 91 92 92 92 92 91 92 92 92 91 91 92 92 92 92 92 92 92 92 92 92 91 91 92 92 91 91 92 92 92 92 92 91 91 00 00 00 00 00
00 00 00 00 00 91 91 92 92 92 92 92 92 92 92 92 92 91 92 92 92 92 92 92 92 92 92 92 92 92 92 92 92 92 92 91 91 92 92 92 92 92 92 92 92 92 92 92 92 92 92 92 92 92 92 92 92 92 92 92 92 92 92 92 92 92 92 92 92 92 92 92 92 92 92 92 92 92 92 92 91 91 92 92 92 92 92 92 92 92 92 92 91 91 92 92 92 92 92 92 92 92 92 91 91 00 00 00 00 00
00 00 00 00 00 91 91 92 92 92 92 92 92 92 92 92 92 91 92 92 92 92 91 91 92 92 92 92 92 92 92 92 92 92 92 91 91 92 92 92 92 92 92 92 92 92 92 92 92 92 92 92 92 92 92 92 92 92 92 92 92 92 92 92 92 92 92 92 92 92 92 92 92 92 92 92 92 92 92 92 92 92 92 92 91 92 92 92 92 92 92 92 91 91 92 92 92 92 92 92 92 92 92 91 91 00 00 00 00 00
00 00 00 00 00 91 91 92 92 92 92 92 92 92 92 92 92 91 91 91 91 91 91 91 92 92 92 92 92 92 92 92 92 92 92 91 91 91 91 91 91 91 91 92 92 92 92 92 92 92 92 92 92 92 92 92 92 92 92 92 92 92 92 92 92 92 92 92 92 92 92 92 92 92 92 92 92 92 92 92 91 92 92 92 91 92 92 92 91 92 92 92 91 91 92 92 92 92 92 92 92 92 92 91 91 00 00 00 00 00
00 00 00 00 00 91 91 91 91 91 91 91 91 91 91 91 91 92 92 92 92 92 92 92 91 91 91 91 91 91 91 91 91 91 91 91 91 91 91 91 91 91 91 92 92 92 91 92 91 91 91 91 91 91 91 91 91 91 91 91 91 91 91 91 91 91 91 91 91 91 91 91 91 91 91 91 91 91 91 91 92 91 91 91 91 91 91 91 91 91 91 91 91 91 91 91 91 91 91 91 91 91 91 91 91 00 00 00 00 00
00 00 00 00 00 91 91 91 91 91 91 91 91 91 91 91 91 91 91 91 91 91 91 91 91 91 91 91 91 91 91 91 91 91 91 91 91 91 91 91 91 91 91 91 91 91 91 91 91 91 91 91 91 91 91 91 91 91 91 91 91 91 91 91 91 91 91 91 91 91 91 91 91 91 91 91 91 91 91 91 91 91 91 91 91 91 91 91 91 91 91 91 91 91 91 91 91 91 91 91 91 91 91 91 91 00 00 00 00 00
